4444444444444444444444244
5000000000000000000000006
5000000000000000000000006
5000000000000000000000006
5000000000000000000000006
5000000111100000000000006
5000000000000000000000006
5000000000000000000000006
5000000000000000000000006
5000000000000000000000006
5000000000000000000000006
5000000000000000000000006
5000000000000000000000006
5000000000000000000000006
5000000000000000000000006
5000000000000000000000006
5000000000000000000000006
5000000000000000000000006
4444444444444444444444444